23,23,23,23,23,23,23,23,23,23,23,23,23,23,23,23,23,23,23,23,23,23,23,23,23,23,23,23,23,23,23,23
23,23,23,23,23,23,23,23,23,23,23,23,23,23,23,23,23,23,23,23,23,23,23,23,23,23,23,23,23,23,23,23
23,23,23,23,23,23,23,23,23,23,23,23,23,23,23,23,23,23,23,23,23,23,23,23,23,23,23,23,23,23,23,23
23,23,23,23,23,23,23,23,23,23,23,23,23,23,01,03,02,02,03,04,23,23,23,23,23,23,23,23,23,23,23,23
23,23,23,23,23,23,23,23,01,03,02,03,03,02,35,22,22,22,22,15,03,02,03,03,02,03,04,23,23,23,23,23
23,23,23,23,23,23,23,01,35,22,22,22,22,22,22,22,22,22,22,22,22,22,22,22,22,22,15,04,23,23,23,23
23,23,23,23,23,23,01,35,22,22,22,22,22,22,22,22,22,22,22,22,22,22,22,22,22,22,22,24,23,23,23,23
23,23,23,23,23,23,21,22,22,22,22,22,22,22,22,22,22,22,22,22,22,22,22,22,22,22,22,15,03,04,23,23
23,23,23,23,23,01,35,22,22,22,22,22,22,22,22,22,22,22,22,22,22,22,22,22,22,22,22,22,22,24,23,23
23,23,23,23,23,11,22,22,22,22,22,22,22,22,22,22,22,22,22,22,22,22,22,22,22,22,22,22,22,14,23,23
23,23,23,23,23,21,22,22,22,22,22,22,22,22,22,22,22,22,22,22,22,22,22,22,22,22,22,22,22,24,23,23
23,23,23,23,23,11,22,22,22,22,22,22,22,22,22,22,22,22,22,22,22,22,22,22,22,22,22,22,22,14,23,23
23,23,23,23,01,35,22,22,22,22,22,22,22,22,22,22,22,22,22,22,22,22,22,22,22,22,22,22,22,14,23,23
23,23,23,23,11,22,22,22,22,22,22,22,22,22,22,22,22,22,22,22,22,22,22,22,22,22,22,22,05,34,23,23
23,23,23,23,21,22,22,22,22,22,22,22,22,22,22,22,22,22,22,22,22,22,22,22,22,22,22,22,14,23,23,23
23,23,23,23,21,22,22,22,22,22,22,22,22,22,22,22,22,22,22,22,22,22,22,22,22,22,22,22,24,23,23,23
23,23,23,23,11,22,22,22,22,22,22,22,22,22,22,22,22,22,22,22,22,22,22,22,22,22,22,22,24,23,23,23
23,23,23,23,21,22,22,22,22,22,22,22,22,22,22,22,22,22,22,22,22,22,22,22,22,22,22,22,24,23,23,23
23,23,23,23,11,22,22,22,22,22,22,22,22,22,22,22,22,22,22,22,22,22,22,22,22,22,22,22,14,23,23,23
23,23,23,23,21,22,22,22,22,22,22,22,22,22,22,22,22,22,22,22,22,22,22,22,22,22,22,05,34,23,23,23
23,23,23,23,31,25,22,22,22,22,22,22,22,22,22,22,22,22,22,22,22,22,22,05,32,25,22,15,04,23,23,23
23,23,23,23,23,21,22,22,22,22,22,22,22,22,22,22,22,22,22,22,22,22,05,34,23,11,22,22,14,23,23,23
23,23,23,23,23,11,22,22,22,22,22,22,22,22,22,22,22,22,22,22,22,22,24,23,23,11,22,22,24,23,23,23
23,23,23,23,23,31,25,22,22,22,22,22,22,22,22,22,22,22,22,22,22,22,14,23,23,31,25,22,14,23,23,23
23,23,23,23,23,23,31,25,22,22,22,22,22,22,22,22,22,22,22,22,22,22,14,23,23,23,31,32,34,23,23,23
23,23,23,23,23,23,23,11,22,22,22,22,22,22,22,22,22,22,22,22,22,22,14,23,23,23,23,23,23,23,23,23
23,23,23,23,23,23,23,21,22,22,22,22,22,22,22,22,22,22,22,22,22,22,24,23,23,23,23,23,23,23,23,23
23,23,23,23,23,23,23,31,32,33,32,25,22,22,22,22,22,22,22,22,22,22,14,23,23,23,23,23,23,23,23,23
23,23,23,23,23,23,23,23,23,23,23,31,33,25,22,22,22,22,22,22,22,05,34,23,23,23,23,23,23,23,23,23
23,23,23,23,23,23,23,23,23,23,23,23,23,31,33,33,32,33,33,32,33,34,23,23,23,23,23,23,23,23,23,23
23,23,23,23,23,23,23,23,23,23,23,23,23,23,23,23,23,23,23,23,23,23,23,23,23,23,23,23,23,23,23,23
23,23,23,23,23,23,23,23,23,23,23,23,23,23,23,23,23,23,23,23,23,23,23,23,23,23,23,23,23,23,23,23
