15,15,15,15,15,15,15,15,15,15,15,15,15,15,15,15,15,15,15,15,15,15,15,15,15,15,15,15,15,15,15,15
15,15,15,15,15,15,15,15,15,15,15,15,15,15,15,15,15,15,15,15,15,15,15,15,15,15,15,15,15,15,15,15
15,15,15,15,15,15,15,15,15,15,15,15,15,15,15,15,15,15,15,15,15,15,15,15,15,15,15,15,15,15,15,15
15,15,15,15,15,15,15,15,15,15,15,15,15,15,01,03,02,02,03,04,15,15,15,15,15,15,15,15,15,15,15,15
15,15,15,15,15,15,15,15,01,03,02,03,03,02,23,14,14,14,14,11,03,02,03,03,02,03,04,15,15,15,15,15
15,15,15,15,15,15,15,01,23,14,14,14,14,14,14,14,14,14,14,14,14,14,14,14,14,14,11,04,15,15,15,15
15,15,15,15,15,15,01,23,14,14,14,14,14,14,14,14,14,14,14,14,14,14,14,14,14,14,14,16,15,15,15,15
15,15,15,15,15,15,13,14,14,14,14,14,14,14,14,14,14,14,14,14,14,14,14,14,14,14,14,11,03,04,15,15
15,15,15,15,15,01,23,14,14,14,14,14,14,14,14,14,14,14,14,14,14,14,14,14,14,14,14,14,14,16,15,15
15,15,15,15,15,07,14,14,14,14,14,14,14,14,14,14,14,14,14,14,14,14,14,14,14,14,14,14,14,10,15,15
15,15,15,15,15,13,14,14,14,14,14,14,14,14,14,14,14,14,14,14,14,14,14,14,14,14,14,14,14,16,15,15
15,15,15,15,15,07,14,14,14,14,14,14,14,14,14,14,14,14,14,14,14,14,14,14,14,14,14,14,14,10,15,15
15,15,15,15,01,23,14,14,14,14,14,14,14,14,14,14,14,14,14,14,14,14,14,14,14,14,14,14,14,10,15,15
15,15,15,15,07,14,14,14,14,14,14,14,14,14,14,14,14,14,14,14,14,14,14,14,14,14,14,14,05,22,15,15
15,15,15,15,13,14,14,14,14,14,14,14,14,14,14,14,14,14,14,14,14,14,14,14,14,14,14,14,10,15,15,15
15,15,15,15,13,14,14,14,14,14,14,14,14,14,14,14,14,14,14,14,14,14,14,14,14,14,14,14,16,15,15,15
15,15,15,15,07,14,14,14,14,14,14,14,14,14,14,14,14,14,14,14,14,14,14,14,14,14,14,14,16,15,15,15
15,15,15,15,13,14,14,14,14,14,14,14,14,14,14,14,14,14,14,14,14,14,14,14,14,14,14,14,16,15,15,15
15,15,15,15,07,14,14,14,14,14,14,14,14,14,14,14,14,14,14,14,14,14,14,14,14,14,14,14,10,15,15,15
15,15,15,15,13,14,14,14,14,14,14,14,14,14,14,14,14,14,14,14,14,14,14,14,14,14,14,05,22,15,15,15
15,15,15,15,19,17,14,14,14,14,14,14,14,14,14,14,14,14,14,14,14,14,14,05,20,17,14,11,04,15,15,15
15,15,15,15,15,13,14,14,14,14,14,14,14,14,14,14,14,14,14,14,14,14,05,22,15,07,14,14,10,15,15,15
15,15,15,15,15,07,14,14,14,14,14,14,14,14,14,14,14,14,14,14,14,14,16,15,15,07,14,14,16,15,15,15
15,15,15,15,15,19,17,14,14,14,14,14,14,14,14,14,14,14,14,14,14,14,10,15,15,19,17,14,10,15,15,15
15,15,15,15,15,15,19,17,14,14,14,14,14,14,14,14,14,14,14,14,14,14,10,15,15,15,19,20,22,15,15,15
15,15,15,15,15,15,15,07,14,14,14,14,14,14,14,14,14,14,14,14,14,14,10,15,15,15,15,15,15,15,15,15
15,15,15,15,15,15,15,13,14,14,14,14,14,14,14,14,14,14,14,14,14,14,16,15,15,15,15,15,15,15,15,15
15,15,15,15,15,15,15,19,20,21,20,17,14,14,14,14,14,14,14,14,14,14,10,15,15,15,15,15,15,15,15,15
15,15,15,15,15,15,15,15,15,15,15,19,21,17,14,14,14,14,14,14,14,05,22,15,15,15,15,15,15,15,15,15
15,15,15,15,15,15,15,15,15,15,15,15,15,19,21,21,20,21,21,20,21,22,15,15,15,15,15,15,15,15,15,15
15,15,15,15,15,15,15,15,15,15,15,15,15,15,15,15,15,15,15,15,15,15,15,15,15,15,15,15,15,15,15,15
15,15,15,15,15,15,15,15,15,15,15,15,15,15,15,15,15,15,15,15,15,15,15,15,15,15,15,15,15,15,15,15