22,22,22,22,22,22,22,22,22,22,22,22,22,22,22,22,22,22,22,22,22,22,22,22,22,22,22,22,22,22,22,22
22,22,22,22,22,22,22,22,22,22,22,22,22,22,22,22,22,22,22,22,22,22,22,22,22,22,22,22,22,22,22,22
22,22,22,22,22,22,22,22,22,22,22,22,22,22,22,22,22,22,22,22,22,22,22,22,22,22,22,22,22,22,22,22
22,22,22,22,22,22,22,22,22,22,22,22,22,22,00,01,02,02,01,03,22,22,22,22,22,22,22,22,22,22,22,22
22,22,22,22,22,22,22,22,00,01,02,01,01,02,34,21,21,21,21,14,01,02,01,01,02,01,03,22,22,22,22,22
22,22,22,22,22,22,22,00,34,21,21,21,21,21,21,21,21,21,21,21,21,21,21,21,21,21,14,03,22,22,22,22
22,22,22,22,22,22,00,34,21,21,21,21,21,21,21,21,21,21,21,21,21,21,21,21,21,21,21,13,22,22,22,22
22,22,22,22,22,22,10,21,21,21,21,21,21,21,21,21,21,21,21,21,21,21,21,21,21,21,21,14,01,03,22,22
22,22,22,22,22,00,34,21,21,21,21,21,21,21,21,21,21,21,21,21,21,21,21,21,21,21,21,21,21,23,22,22
22,22,22,22,22,20,21,21,21,21,21,21,21,21,21,21,21,21,21,21,21,21,21,21,21,21,21,21,21,23,22,22
22,22,22,22,22,10,21,21,21,21,21,21,21,21,21,21,21,21,21,21,21,21,21,21,21,21,21,21,21,23,22,22
22,22,22,22,22,20,21,21,21,21,21,21,21,21,21,21,21,21,21,21,21,21,21,21,21,21,21,21,21,23,22,22
22,22,22,22,00,34,21,21,21,21,21,21,21,21,21,21,21,21,21,21,21,21,21,21,21,21,21,21,21,23,22,22
22,22,22,22,20,21,21,21,21,21,21,21,21,21,21,21,21,21,21,21,21,21,21,21,21,21,21,21,04,33,22,22
22,22,22,22,10,21,21,21,21,21,21,21,21,21,21,21,21,21,21,21,21,21,21,21,21,21,21,21,23,22,22,22
22,22,22,22,10,21,21,21,21,21,21,21,21,21,21,21,21,21,21,21,21,21,21,21,21,21,21,21,23,22,22,22
22,22,22,22,20,21,21,21,21,21,21,21,21,21,21,21,21,21,21,21,21,21,21,21,21,21,21,21,23,22,22,22
22,22,22,22,10,21,21,21,21,21,21,21,21,21,21,21,21,21,21,21,21,21,21,21,21,21,21,21,23,22,22,22
22,22,22,22,20,21,21,21,21,21,21,21,21,21,21,21,21,21,21,21,21,21,21,21,21,21,21,21,23,22,22,22
22,22,22,22,10,21,21,21,21,21,21,21,21,21,21,21,21,21,21,21,21,21,21,21,21,21,21,04,33,22,22,22
22,22,22,22,30,24,21,21,21,21,21,21,21,21,21,21,21,21,21,21,21,21,21,04,32,24,21,14,03,22,22,22
22,22,22,22,22,10,21,21,21,21,21,21,21,21,21,21,21,21,21,21,21,21,04,33,22,20,21,21,13,22,22,22
22,22,22,22,22,20,21,21,21,21,21,21,21,21,21,21,21,21,21,21,21,21,23,22,22,20,21,21,13,22,22,22
22,22,22,22,22,30,24,21,21,21,21,21,21,21,21,21,21,21,21,21,21,21,13,22,22,30,24,21,13,22,22,22
22,22,22,22,22,22,30,24,21,21,21,21,21,21,21,21,21,21,21,21,21,21,13,22,22,22,30,32,33,22,22,22
22,22,22,22,22,22,22,20,21,21,21,21,21,21,21,21,21,21,21,21,21,21,13,22,22,22,22,22,22,22,22,22
22,22,22,22,22,22,22,10,21,21,21,21,21,21,21,21,21,21,21,21,21,21,23,22,22,22,22,22,22,22,22,22
22,22,22,22,22,22,22,30,32,31,32,24,21,21,21,21,21,21,21,21,21,21,13,22,22,22,22,22,22,22,22,22
22,22,22,22,22,22,22,22,22,22,22,30,31,24,21,21,21,21,21,21,21,04,33,22,22,22,22,22,22,22,22,22
22,22,22,22,22,22,22,22,22,22,22,22,22,30,31,31,32,31,31,32,31,33,22,22,22,22,22,22,22,22,22,22
22,22,22,22,22,22,22,22,22,22,22,22,22,22,22,22,22,22,22,22,22,22,22,22,22,22,22,22,22,22,22,22
22,22,22,22,22,22,22,22,22,22,22,22,22,22,22,22,22,22,22,22,22,22,22,22,22,22,22,22,22,22,22,22