22,22,22,22,22,22,22,22,22,22,22,22,22,22,22,22,22,22,22,22,22,22,22,22,22,22,22,22,22,22,22,22
22,22,22,22,22,22,22,22,22,22,22,22,22,22,22,22,22,22,22,22,22,22,22,22,22,22,22,22,22,22,22,22
22,22,22,22,22,22,22,22,22,22,22,22,22,22,22,22,22,22,22,22,22,22,22,22,22,22,22,22,22,22,22,22
22,22,22,22,22,22,22,22,22,22,22,22,22,22,22,22,22,22,22,22,22,22,22,22,22,22,22,22,22,22,22,22
22,22,22,22,22,22,22,22,22,22,22,22,22,22,22,22,22,22,22,22,22,22,22,22,22,22,22,22,22,22,22,22
22,22,22,22,22,22,22,22,22,22,00,02,02,02,02,02,02,02,02,03,22,22,22,22,22,22,22,22,22,22,22,22
22,22,22,22,22,22,22,22,22,00,34,21,21,21,21,21,21,21,21,14,02,02,03,22,22,22,22,22,22,22,22,22
22,22,22,22,22,22,22,22,00,34,21,21,21,21,21,21,21,21,21,21,21,21,14,03,22,22,22,22,22,22,22,22
22,22,22,22,22,22,22,22,10,21,21,21,21,21,21,21,21,21,21,21,21,21,21,13,22,22,22,22,22,22,22,22
22,22,22,22,22,22,22,00,34,21,21,21,21,21,21,21,21,21,21,21,21,21,21,14,03,22,22,22,22,22,22,22
22,22,22,22,22,22,22,10,21,21,21,21,21,21,21,21,21,21,21,21,21,21,21,21,13,22,22,22,22,22,22,22
22,22,22,22,22,22,00,34,21,21,21,21,21,21,21,21,21,21,21,21,21,21,21,21,13,22,22,22,22,22,22,22
22,22,22,22,22,22,10,21,21,21,21,21,21,21,21,21,21,21,21,21,21,21,21,21,14,03,22,22,22,22,22,22
22,22,22,22,22,22,10,21,21,21,21,21,21,21,21,21,21,21,21,21,21,21,21,21,21,13,22,22,22,22,22,22
22,22,22,22,22,22,10,21,21,21,21,21,21,21,21,21,21,21,21,21,21,21,21,21,21,13,22,22,22,22,22,22
22,22,22,22,22,22,10,21,21,21,21,21,21,21,21,21,21,21,21,21,21,21,21,21,21,13,22,22,22,22,22,22
22,22,22,22,22,22,10,21,21,21,21,21,21,21,21,21,21,21,21,21,21,21,21,21,21,13,22,22,22,22,22,22
22,22,22,22,22,22,10,21,21,21,21,21,21,21,21,21,21,21,21,21,21,21,21,21,21,13,22,22,22,22,22,22
22,22,22,22,22,22,10,21,21,21,21,21,21,21,21,21,21,21,21,21,21,21,21,21,04,33,22,22,22,22,22,22
22,22,22,22,22,22,10,21,21,21,21,21,21,21,21,21,21,21,21,21,21,21,21,21,13,22,22,22,22,22,22,22
22,22,22,22,22,22,30,24,21,21,21,21,21,21,21,21,21,21,21,21,21,21,21,21,13,22,22,22,22,22,22,22
22,22,22,22,22,22,22,30,24,21,21,21,21,21,21,21,21,21,21,21,21,21,21,04,33,22,22,22,22,22,22,22
22,22,22,22,22,22,22,22,30,24,21,21,21,21,21,21,21,21,21,21,21,21,21,13,22,22,22,22,22,22,22,22
22,22,22,22,22,22,22,22,22,30,24,21,21,21,21,21,21,21,21,21,21,04,32,33,22,22,22,22,22,22,22,22
22,22,22,22,22,22,22,22,22,22,30,32,32,24,21,21,21,21,21,04,32,33,22,22,22,22,22,22,22,22,22,22
22,22,22,22,22,22,22,22,22,22,22,22,22,30,32,32,32,32,32,33,22,22,22,22,22,22,22,22,22,22,22,22
22,22,22,22,22,22,22,22,22,22,22,22,22,22,22,22,22,22,22,22,22,22,22,22,22,22,22,22,22,22,22,22
22,22,22,22,22,22,22,22,22,22,22,22,22,22,22,22,22,22,22,22,22,22,22,22,22,22,22,22,22,22,22,22
22,22,22,22,22,22,22,22,22,22,22,22,22,22,22,22,22,22,22,22,22,22,22,22,22,22,22,22,22,22,22,22
22,22,22,22,22,22,22,22,22,22,22,22,22,22,22,22,22,22,22,22,22,22,22,22,22,22,22,22,22,22,22,22
22,22,22,22,22,22,22,22,22,22,22,22,22,22,22,22,22,22,22,22,22,22,22,22,22,22,22,22,22,22,22,22
22,22,22,22,22,22,22,22,22,22,22,22,22,22,22,22,22,22,22,22,22,22,22,22,22,22,22,22,22,22,22,22

0,0,0,0,0,0,0,0,0,0,0,0,0,0,0,0,0,0,0,0,0,0,0,0,0,0,0,0,0,0,0,0
0,0,0,0,0,0,0,0,0,0,0,0,0,0,0,0,0,0,0,0,0,0,0,0,0,0,0,0,0,0,0,0
0,0,0,0,0,0,0,0,0,0,0,0,0,0,0,0,0,0,0,0,0,0,0,0,0,0,0,0,0,0,0,0
0,0,0,0,0,0,0,0,0,0,0,0,0,0,0,0,0,0,0,0,0,0,0,0,0,0,0,0,0,0,0,0
0,0,0,0,0,0,0,0,0,0,1,1,1,1,1,1,1,1,1,1,0,0,0,0,0,0,0,0,0,0,0,0
0,0,0,0,0,0,0,0,0,1,0,0,0,0,0,0,0,0,0,0,1,1,1,0,0,0,0,0,0,0,0,0
0,0,0,0,0,0,0,0,1,0,0,0,0,0,0,0,0,0,0,0,0,0,0,1,0,0,0,0,0,0,0,0
0,0,0,0,0,0,0,1,0,0,0,0,0,0,0,0,0,0,0,0,0,0,0,0,1,0,0,0,0,0,0,0
0,0,0,0,0,0,0,1,0,0,0,0,0,0,0,0,0,0,0,0,0,0,0,0,1,0,0,0,0,0,0,0
0,0,0,0,0,0,1,0,0,0,0,0,0,0,0,0,0,0,0,0,0,0,0,0,0,1,0,0,0,0,0,0
0,0,0,0,0,0,1,0,0,0,0,0,0,0,0,0,0,0,0,0,0,0,0,0,0,1,0,0,0,0,0,0
0,0,0,0,0,1,0,0,0,0,0,0,0,0,0,0,0,0,0,0,0,0,0,0,0,1,0,0,0,0,0,0
0,0,0,0,0,1,0,0,0,0,0,0,0,0,0,0,0,0,0,0,0,0,0,0,0,0,1,0,0,0,0,0
0,0,0,0,0,1,0,0,0,0,0,0,0,0,0,0,0,0,0,0,0,0,0,0,0,0,1,0,0,0,0,0
0,0,0,0,0,1,0,0,0,0,0,0,0,0,0,0,0,0,0,0,0,0,0,0,0,0,1,0,0,0,0,0
0,0,0,0,0,1,0,0,0,0,0,0,0,0,0,0,0,0,0,0,0,0,0,0,0,0,1,0,0,0,0,0
0,0,0,0,0,1,0,0,0,0,0,0,0,0,0,0,0,0,0,0,0,0,0,0,0,0,1,0,0,0,0,0
0,0,0,0,0,1,0,0,0,0,0,0,0,0,0,0,0,0,0,0,0,0,0,0,0,0,1,0,0,0,0,0
0,0,0,0,0,1,0,0,0,0,0,0,0,0,0,0,0,0,0,0,0,0,0,0,0,0,1,0,0,0,0,0
0,0,0,0,0,1,0,0,0,0,0,0,0,0,0,0,0,0,0,0,0,0,0,0,0,1,0,0,0,0,0,0
0,0,0,0,0,1,0,0,0,0,0,0,0,0,0,0,0,0,0,0,0,0,0,0,0,1,0,0,0,0,0,0
0,0,0,0,0,0,1,0,0,0,0,0,0,0,0,0,0,0,0,0,0,0,0,0,0,1,0,0,0,0,0,0
0,0,0,0,0,0,0,1,0,0,0,0,0,0,0,0,0,0,0,0,0,0,0,0,1,0,0,0,0,0,0,0
0,0,0,0,0,0,0,0,1,0,0,0,0,0,0,0,0,0,0,0,0,0,0,0,1,0,0,0,0,0,0,0
0,0,0,0,0,0,0,0,0,1,0,0,0,0,0,0,0,0,0,0,0,0,1,1,0,0,0,0,0,0,0,0
0,0,0,0,0,0,0,0,0,0,1,1,1,0,0,0,0,0,0,0,1,1,0,0,0,0,0,0,0,0,0,0
0,0,0,0,0,0,0,0,0,0,0,0,0,1,1,1,1,1,1,1,0,0,0,0,0,0,0,0,0,0,0,0
0,0,0,0,0,0,0,0,0,0,0,0,0,0,0,0,0,0,0,0,0,0,0,0,0,0,0,0,0,0,0,0
0,0,0,0,0,0,0,0,0,0,0,0,0,0,0,0,0,0,0,0,0,0,0,0,0,0,0,0,0,0,0,0
0,0,0,0,0,0,0,0,0,0,0,0,0,0,0,0,0,0,0,0,0,0,0,0,0,0,0,0,0,0,0,0
0,0,0,0,0,0,0,0,0,0,0,0,0,0,0,0,0,0,0,0,0,0,0,0,0,0,0,0,0,0,0,0
0,0,0,0,0,0,0,0,0,0,0,0,0,0,0,0,0,0,0,0,0,0,0,0,0,0,0,0,0,0,0,0
